0 0 0 0 0 0 0 0 0 0 0 0 0 0 0 0 0 0 0 0 0 0 0 0 0 0 0 0 0 0 0 0 0 0 0 0 0 0 0 0 0 0 0 0 0 0 0 0 0 0 
0 0 0 0 0 0 0 0 0 0 0 0 0 0 0 0 0 0 0 0 0 0 0 0 0 0 0 0 0 0 0 0 0 0 0 0 0 0 0 0 0 0 0 0 0 0 0 0 0 0 
0 0 0 0 0 0 0 0 0 0 0 0 0 0 0 0 0 0 0 0 0 0 0 0 0 0 0 0 0 0 0 0 0 0 0 0 0 0 0 0 0 0 0 0 0 0 0 0 0 0 
0 0 0 0 0 0 0 0 0 0 0 0 0 0 0 0 0 0 0 0 0 0 0 0 0 0 0 0 0 0 0 0 0 0 0 0 0 0 0 0 0 0 0 0 0 0 0 0 0 0 
0 0 0 0 0 0 0 0 0 0 0 0 0 0 0 0 0 0 0 0 0 0 0 0 0 0 0 0 0 0 0 0 0 0 0 0 0 0 0 0 0 0 0 0 0 0 0 0 0 0 
0 0 0 0 0 0 0 0 0 0 0 0 0 0 0 0 0 0 0 0 0 0 0 0 0 0 0 0 0 0 0 0 0 0 0 0 0 0 0 0 0 0 0 0 0 0 0 0 0 0 
0 0 0 0 0 0 0 56 56 56 56 56 56 56 56 56 56 56 56 56 56 56 56 56 56 56 56 56 56 56 56 56 56 56 56 56 56 56 56 56 56 56 56 0 0 0 0 0 0 0 
0 0 0 0 0 0 0 56 36 27 56 56 56 56 56 56 56 56 56 56 56 56 56 56 56 56 56 56 56 56 56 56 56 56 56 56 56 56 56 56 56 56 56 0 0 0 0 0 0 0 
0 0 0 0 0 0 0 56 27 27 56 56 56 56 56 27 27 27 27 27 27 56 56 56 56 56 56 56 56 56 56 27 27 27 27 27 27 56 56 56 56 56 56 0 0 0 0 0 0 0 
0 0 0 0 0 0 0 56 56 27 56 56 56 56 27 27 27 27 27 27 27 27 56 56 56 56 56 56 56 56 27 27 27 27 56 56 27 56 56 56 56 56 56 0 0 0 0 0 0 0 
0 0 0 0 0 0 0 56 56 27 27 27 27 27 27 27 27 27 27 27 27 27 56 56 56 56 27 27 27 27 27 27 27 56 56 56 27 27 56 56 56 56 56 0 0 0 0 0 0 0 
0 0 0 0 0 0 0 56 56 56 56 56 56 56 27 27 27 27 27 27 27 27 56 56 56 27 27 27 27 27 27 27 56 56 56 56 56 27 56 56 56 56 56 0 0 0 0 0 0 0 
0 0 0 0 0 0 0 56 56 56 56 56 56 56 56 27 27 27 27 27 27 56 56 56 27 27 27 27 27 27 56 56 56 56 56 56 56 27 27 56 56 56 56 0 0 0 0 0 0 0 
0 0 0 0 0 0 0 56 56 56 56 56 56 56 56 56 56 56 27 56 56 56 56 27 27 27 27 56 56 56 56 56 56 56 56 56 27 27 27 27 56 56 56 0 0 0 0 0 0 0 
0 0 0 0 0 0 0 56 56 56 56 56 56 56 56 56 56 56 27 56 56 56 27 27 27 56 56 56 56 56 56 56 56 56 56 27 27 27 27 27 56 56 56 0 0 0 0 0 0 0 
0 0 0 0 0 0 0 56 56 56 56 56 56 56 56 27 27 27 27 27 56 56 27 27 27 56 56 27 56 56 56 56 56 56 56 27 27 27 27 27 27 56 56 0 0 0 0 0 0 0 
0 0 0 0 0 0 0 56 56 56 56 56 56 27 27 27 56 27 27 27 56 56 27 56 56 56 56 27 56 56 56 56 56 56 27 27 27 27 27 27 27 56 56 0 0 0 0 0 0 0 
0 0 0 0 0 0 0 56 27 27 56 56 56 56 56 56 56 56 27 56 56 56 27 56 56 27 27 27 27 27 56 56 27 27 27 56 56 27 27 27 56 56 56 0 0 0 0 0 0 0 
0 0 0 0 0 0 0 56 27 27 27 27 27 56 56 56 56 56 27 56 56 56 27 56 56 27 27 27 27 27 56 27 27 56 56 56 56 56 27 56 56 56 56 0 0 0 0 0 0 0 
0 0 0 0 0 0 0 56 27 27 27 27 27 56 56 56 56 56 27 56 56 56 27 56 56 27 27 27 27 27 27 27 56 56 56 56 56 56 27 56 56 56 56 0 0 0 0 0 0 0 
0 0 0 0 0 0 0 56 27 27 27 27 27 56 56 56 56 56 27 56 56 56 27 56 56 56 27 27 27 27 56 56 56 56 56 56 56 56 27 56 56 56 56 0 0 0 0 0 0 0 
0 0 0 0 0 0 0 56 27 27 27 27 27 56 56 56 56 56 27 56 56 56 27 27 56 56 56 56 56 56 56 56 56 56 56 56 56 56 27 56 56 56 56 0 0 0 0 0 0 0 
0 0 0 0 0 0 0 56 56 56 27 56 56 56 56 56 56 56 27 56 27 27 27 27 56 56 56 56 56 56 56 56 56 56 56 56 56 56 27 56 56 56 56 0 0 0 0 0 0 0 
0 0 0 0 0 0 0 56 56 56 27 56 56 56 56 56 56 56 27 56 56 56 56 56 56 56 56 56 56 56 56 56 56 56 56 56 56 27 27 27 27 56 56 0 0 0 0 0 0 0 
0 0 0 0 0 0 0 56 56 56 27 56 56 56 27 27 27 27 27 27 27 27 56 56 56 56 56 56 56 56 56 56 56 56 27 27 27 27 27 27 27 56 56 0 0 0 0 0 0 0 
0 0 0 0 0 0 0 56 56 56 27 56 56 27 27 27 27 27 27 27 27 27 27 56 56 56 56 56 56 56 56 56 27 27 27 27 27 27 27 27 27 56 56 0 0 0 0 0 0 0 
0 0 0 0 0 0 0 56 56 56 27 27 27 27 27 27 27 27 27 27 27 27 27 56 56 56 56 56 56 56 56 56 27 27 27 27 27 27 27 27 27 56 56 0 0 0 0 0 0 0 
0 0 0 0 0 0 0 56 56 56 27 27 27 27 27 27 27 27 27 27 27 27 27 56 56 56 56 56 56 56 56 56 27 27 27 27 27 27 27 27 27 56 56 0 0 0 0 0 0 0 
0 0 0 0 0 0 0 56 56 56 56 56 56 56 27 27 27 27 27 27 27 27 27 27 27 27 27 27 27 27 27 27 27 27 27 27 27 56 56 27 27 56 56 0 0 0 0 0 0 0 
0 0 0 0 0 0 0 56 56 56 56 56 56 56 56 56 56 27 27 56 56 56 56 56 56 56 27 56 56 56 56 56 27 27 27 56 56 56 56 27 27 56 56 0 0 0 0 0 0 0 
0 0 0 0 0 0 0 56 56 56 56 56 56 56 56 56 56 27 27 56 56 56 56 56 56 56 27 56 56 56 56 56 56 56 56 56 56 56 27 27 27 56 56 0 0 0 0 0 0 0 
0 0 0 0 0 0 0 56 56 56 56 56 56 56 56 56 56 27 27 56 56 56 56 56 56 56 27 56 56 56 56 56 56 56 56 56 56 56 56 27 27 56 56 0 0 0 0 0 0 0 
0 0 0 0 0 0 0 56 56 56 56 56 56 56 56 56 56 27 27 56 56 56 56 56 56 56 27 56 56 56 56 56 56 56 56 56 56 56 56 56 56 56 56 0 0 0 0 0 0 0 
0 0 0 0 0 0 0 56 56 56 56 56 56 56 56 56 56 27 27 56 56 56 56 56 56 27 27 27 56 56 56 56 56 56 56 56 56 56 56 56 56 56 56 0 0 0 0 0 0 0 
0 0 0 0 0 0 0 56 56 56 56 56 56 56 56 56 56 27 27 56 56 56 56 56 56 27 27 27 56 56 56 56 56 56 56 56 56 56 56 56 56 56 56 0 0 0 0 0 0 0 
0 0 0 0 0 0 0 56 56 56 56 56 56 56 56 27 27 27 27 27 27 56 56 56 56 56 56 56 56 56 56 56 56 56 56 56 56 56 56 56 56 56 56 0 0 0 0 0 0 0 
0 0 0 0 0 0 0 56 56 56 56 56 56 56 56 27 27 27 27 27 27 56 56 56 56 56 56 56 56 56 56 56 56 56 56 56 56 56 56 56 56 56 56 0 0 0 0 0 0 0 
0 0 0 0 0 0 0 56 56 27 27 27 27 27 27 27 27 27 27 27 27 56 56 56 56 56 56 56 56 56 56 56 56 56 56 56 27 27 27 27 27 56 56 0 0 0 0 0 0 0 
0 0 0 0 0 0 0 56 56 27 56 56 56 56 56 27 27 27 27 27 27 56 56 56 56 56 56 56 56 56 56 56 27 27 27 27 27 27 56 56 27 56 56 0 0 0 0 0 0 0 
0 0 0 0 0 0 0 56 56 27 56 56 56 56 56 27 27 27 27 27 27 56 56 56 56 56 56 56 56 56 56 27 27 27 27 27 27 56 56 56 27 56 56 0 0 0 0 0 0 0
0 0 0 0 0 0 0 56 27 27 27 56 56 56 56 83 27 27 27 27 27 27 27 27 27 27 27 27 27 27 27 27 27 27 27 27 27 56 56 56 27 56 56 0 0 0 0 0 0 0
0 0 0 0 0 0 0 56 27 37 27 56 56 56 56 56 56 56 56 56 56 56 56 56 56 56 56 56 56 56 56 56 27 27 27 27 27 56 56 56 27 56 56 0 0 0 0 0 0 0 
0 0 0 0 0 0 0 56 27 27 27 56 56 56 56 56 56 56 56 56 56 56 56 56 56 56 56 56 56 56 56 56 56 56 56 56 56 56 56 56 56 56 56 0 0 0 0 0 0 0 
0 0 0 0 0 0 0 56 56 56 56 56 56 56 56 56 56 56 56 56 56 56 56 56 56 56 56 56 56 56 56 56 56 56 56 56 56 56 56 56 56 56 56 0 0 0 0 0 0 0 
0 0 0 0 0 0 0 0 0 0 0 0 0 0 0 0 0 0 0 0 0 0 0 0 0 0 0 0 0 0 0 0 0 0 0 0 0 0 0 0 0 0 0 0 0 0 0 0 0 0 
0 0 0 0 0 0 0 0 0 0 0 0 0 0 0 0 0 0 0 0 0 0 0 0 0 0 0 0 0 0 0 0 0 0 0 0 0 0 0 0 0 0 0 0 0 0 0 0 0 0 
0 0 0 0 0 0 0 0 0 0 0 0 0 0 0 0 0 0 0 0 0 0 0 0 0 0 0 0 0 0 0 0 0 0 0 0 0 0 0 0 0 0 0 0 0 0 0 0 0 0 
0 0 0 0 0 0 0 0 0 0 0 0 0 0 0 0 0 0 0 0 0 0 0 0 0 0 0 0 0 0 0 0 0 0 0 0 0 0 0 0 0 0 0 0 0 0 0 0 0 0 
0 0 0 0 0 0 0 0 0 0 0 0 0 0 0 0 0 0 0 0 0 0 0 0 0 0 0 0 0 0 0 0 0 0 0 0 0 0 0 0 0 0 0 0 0 0 0 0 0 0 
0 0 0 0 0 0 0 0 0 0 0 0 0 0 0 0 0 0 0 0 0 0 0 0 0 0 0 0 0 0 0 0 0 0 0 0 0 0 0 0 0 0 0 0 0 0 0 0 0 0 
