0 0 0 0 0 0 0 0 0 0 0 0 0 0 0 0 0 0 0 0 0 0 0 0 0 0 0 0 0 0 0 0 0 0 0 0 0 0 0 0 0 0 0 0 0 0 0 0 0 0 
0 0 0 0 0 0 0 0 0 0 0 0 0 0 0 0 0 0 0 0 0 0 0 0 0 0 0 0 0 0 0 0 0 0 0 0 0 0 0 0 0 0 0 0 0 0 0 0 0 0 
0 0 0 0 0 0 0 0 0 0 0 0 0 0 0 0 0 0 0 0 0 0 0 0 0 0 0 0 0 0 0 0 0 0 0 0 0 0 0 0 0 0 0 0 0 0 0 0 0 0 
0 0 0 0 0 0 0 0 0 0 0 0 0 0 0 0 0 0 0 0 0 0 0 0 0 0 0 0 0 0 0 0 0 0 0 0 0 0 0 0 0 0 0 0 0 0 0 0 0 0 
0 0 0 0 0 0 0 0 0 0 0 0 0 0 0 0 0 0 0 0 0 0 0 0 0 0 0 0 0 0 0 0 0 0 0 0 0 0 0 0 0 0 0 0 0 0 0 0 0 0 
0 0 0 0 0 0 0 0 0 0 0 0 0 0 0 0 0 0 0 0 0 0 0 0 0 0 0 0 0 0 0 0 0 0 0 0 0 0 0 0 0 0 0 0 0 0 0 0 0 0 
0 0 0 0 0 0 0 89 89 89 89 89 89 89 89 89 89 89 89 89 89 89 89 89 89 89 89 89 89 89 89 89 89 89 89 89 89 89 89 89 89 89 89 0 0 0 0 0 0 0 
0 0 0 0 0 0 0 89 36 94 89 89 89 89 89 89 89 89 89 89 89 89 89 89 89 89 89 89 89 89 89 89 89 89 89 89 89 89 89 89 89 89 89 0 0 0 0 0 0 0 
0 0 0 0 0 0 0 89 94 94 89 89 89 89 89 94 94 94 94 94 94 89 89 89 89 89 89 89 89 89 89 94 94 94 94 94 94 89 89 89 89 89 89 0 0 0 0 0 0 0 
0 0 0 0 0 0 0 89 89 94 89 89 89 89 94 94 94 94 94 94 94 94 89 89 89 89 89 89 89 89 94 94 94 94 89 89 94 89 89 89 89 89 89 0 0 0 0 0 0 0 
0 0 0 0 0 0 0 89 89 94 94 94 94 94 94 94 94 94 94 94 94 94 89 89 89 89 94 94 94 94 94 94 94 89 89 89 94 94 89 89 89 89 89 0 0 0 0 0 0 0 
0 0 0 0 0 0 0 89 89 89 89 89 89 89 94 94 94 94 94 94 94 94 89 89 89 94 94 94 94 94 94 94 89 89 89 89 89 94 89 89 89 89 89 0 0 0 0 0 0 0 
0 0 0 0 0 0 0 89 89 89 89 89 89 89 89 94 94 94 94 94 94 89 89 89 94 94 94 94 94 94 89 89 89 89 89 89 89 94 94 89 89 89 89 0 0 0 0 0 0 0 
0 0 0 0 0 0 0 89 89 89 89 89 89 89 89 89 89 89 94 89 89 89 89 94 94 94 94 89 89 89 89 89 89 89 89 89 94 94 94 94 89 89 89 0 0 0 0 0 0 0 
0 0 0 0 0 0 0 89 89 89 89 89 89 89 89 89 89 89 94 89 89 89 94 94 94 89 89 89 89 89 89 89 89 89 89 94 94 94 94 94 89 89 89 0 0 0 0 0 0 0 
0 0 0 0 0 0 0 89 89 89 89 89 89 89 89 94 94 94 94 94 89 89 94 94 94 89 89 94 89 89 89 89 89 89 89 94 94 94 94 94 94 89 89 0 0 0 0 0 0 0 
0 0 0 0 0 0 0 89 89 89 89 89 89 94 94 94 89 94 94 94 89 89 94 89 89 89 89 94 89 89 89 89 89 89 94 94 94 94 94 94 94 89 89 0 0 0 0 0 0 0 
0 0 0 0 0 0 0 89 94 94 89 89 89 89 89 89 89 89 94 89 89 89 94 89 89 94 94 94 94 94 89 89 94 94 94 89 89 94 94 94 89 89 89 0 0 0 0 0 0 0 
0 0 0 0 0 0 0 89 94 94 94 94 94 89 89 89 89 89 94 89 89 89 94 89 89 94 94 94 94 94 89 94 94 89 89 89 89 89 94 89 89 89 89 0 0 0 0 0 0 0 
0 0 0 0 0 0 0 89 94 94 94 94 94 89 89 89 89 89 94 89 89 89 94 89 89 94 94 94 94 94 94 94 89 89 89 89 89 89 94 89 89 89 89 0 0 0 0 0 0 0 
0 0 0 0 0 0 0 89 94 94 94 94 94 89 89 89 89 89 94 89 89 89 94 89 89 89 94 94 94 94 89 89 89 89 89 89 89 89 94 89 89 89 89 0 0 0 0 0 0 0 
0 0 0 0 0 0 0 89 94 94 94 94 94 89 89 89 89 89 94 89 89 89 94 94 89 89 89 89 89 89 89 89 89 89 89 89 89 89 94 89 89 89 89 0 0 0 0 0 0 0 
0 0 0 0 0 0 0 89 89 89 94 89 89 89 89 89 89 89 94 89 94 94 94 94 89 89 89 89 89 89 89 89 89 89 89 89 89 89 94 89 89 89 89 0 0 0 0 0 0 0 
0 0 0 0 0 0 0 89 89 89 94 89 89 89 89 89 89 89 94 89 89 89 89 89 89 89 89 89 89 89 89 89 89 89 89 89 89 94 94 94 94 89 89 0 0 0 0 0 0 0 
0 0 0 0 0 0 0 89 89 89 94 89 89 89 94 94 94 94 94 94 94 94 89 89 89 89 89 89 89 89 89 89 89 89 94 94 94 94 94 94 94 89 89 0 0 0 0 0 0 0 
0 0 0 0 0 0 0 89 89 89 94 89 89 94 94 94 94 94 94 94 94 94 94 89 89 89 89 89 89 89 89 89 94 94 94 94 94 94 94 94 94 89 89 0 0 0 0 0 0 0 
0 0 0 0 0 0 0 89 89 89 94 94 94 94 94 94 94 94 94 94 94 94 94 89 89 89 89 89 89 89 89 89 94 94 94 94 94 94 94 94 94 89 89 0 0 0 0 0 0 0 
0 0 0 0 0 0 0 89 89 89 94 94 94 94 94 94 94 94 94 94 94 94 94 89 89 89 89 89 89 89 89 89 94 94 94 94 94 94 94 94 94 89 89 0 0 0 0 0 0 0 
0 0 0 0 0 0 0 89 89 89 89 89 89 89 94 94 94 94 94 94 94 94 94 94 94 94 94 94 94 94 94 94 94 94 94 94 94 89 89 94 94 89 89 0 0 0 0 0 0 0 
0 0 0 0 0 0 0 89 89 89 89 89 89 89 89 89 89 94 94 89 89 89 89 89 89 89 94 89 89 89 89 89 94 94 94 89 89 89 89 94 94 89 89 0 0 0 0 0 0 0 
0 0 0 0 0 0 0 89 89 89 89 89 89 89 89 89 89 94 94 89 89 89 89 89 89 89 94 89 89 89 89 89 89 89 89 89 89 89 94 94 94 89 89 0 0 0 0 0 0 0 
0 0 0 0 0 0 0 89 89 89 89 89 89 89 89 89 89 94 94 89 89 89 89 89 89 89 94 89 89 89 89 89 89 89 89 89 89 89 89 94 94 89 89 0 0 0 0 0 0 0 
0 0 0 0 0 0 0 89 89 89 89 89 89 89 89 89 89 94 94 89 89 89 89 89 89 89 94 89 89 89 89 89 89 89 89 89 89 89 89 89 89 89 89 0 0 0 0 0 0 0 
0 0 0 0 0 0 0 89 89 89 89 89 89 89 89 89 89 94 94 89 89 89 89 89 89 94 94 94 89 89 89 89 89 89 89 89 89 89 89 89 89 89 89 0 0 0 0 0 0 0 
0 0 0 0 0 0 0 89 89 89 89 89 89 89 89 89 89 94 94 89 89 89 89 89 89 94 94 94 89 89 89 89 89 89 89 89 89 89 89 89 89 89 89 0 0 0 0 0 0 0 
0 0 0 0 0 0 0 89 89 89 89 89 89 89 89 94 94 94 94 94 94 89 89 89 89 89 89 89 89 89 89 89 89 89 89 89 89 89 89 89 89 89 89 0 0 0 0 0 0 0 
0 0 0 0 0 0 0 89 89 89 89 89 89 89 89 94 94 94 94 94 94 89 89 89 89 89 89 89 89 89 89 89 89 89 89 89 89 89 89 89 89 89 89 0 0 0 0 0 0 0 
0 0 0 0 0 0 0 89 89 94 94 94 94 94 94 94 94 94 94 94 94 89 89 89 89 89 89 89 89 89 89 89 89 89 89 89 94 94 94 94 94 89 89 0 0 0 0 0 0 0 
0 0 0 0 0 0 0 89 89 94 89 89 89 89 89 94 94 94 94 94 94 89 89 89 89 89 89 89 89 89 89 89 94 94 94 94 94 94 89 89 94 89 89 0 0 0 0 0 0 0 
0 0 0 0 0 0 0 89 89 94 89 89 89 89 89 84 94 94 94 94 94 89 89 89 89 89 89 89 89 89 89 94 94 94 94 94 94 89 89 89 94 89 89 0 0 0 0 0 0 0
0 0 0 0 0 0 0 89 94 94 94 89 89 89 89 83 94 94 94 94 94 94 94 94 94 94 94 94 94 94 94 94 94 94 94 94 94 89 89 89 94 89 89 0 0 0 0 0 0 0
0 0 0 0 0 0 0 89 94 37 94 89 89 89 89 89 89 89 89 89 89 89 89 89 89 89 89 89 89 89 89 89 94 94 94 94 94 89 89 89 94 89 89 0 0 0 0 0 0 0 
0 0 0 0 0 0 0 89 94 94 94 89 89 89 89 89 89 89 89 89 89 89 89 89 89 89 89 89 89 89 89 89 89 89 89 89 89 89 89 89 89 89 89 0 0 0 0 0 0 0 
0 0 0 0 0 0 0 89 89 89 89 89 89 89 89 89 89 89 89 89 89 89 89 89 89 89 89 89 89 89 89 89 89 89 89 89 89 89 89 89 89 89 89 0 0 0 0 0 0 0 
0 0 0 0 0 0 0 0 0 0 0 0 0 0 0 0 0 0 0 0 0 0 0 0 0 0 0 0 0 0 0 0 0 0 0 0 0 0 0 0 0 0 0 0 0 0 0 0 0 0 
0 0 0 0 0 0 0 0 0 0 0 0 0 0 0 0 0 0 0 0 0 0 0 0 0 0 0 0 0 0 0 0 0 0 0 0 0 0 0 0 0 0 0 0 0 0 0 0 0 0 
0 0 0 0 0 0 0 0 0 0 0 0 0 0 0 0 0 0 0 0 0 0 0 0 0 0 0 0 0 0 0 0 0 0 0 0 0 0 0 0 0 0 0 0 0 0 0 0 0 0 
0 0 0 0 0 0 0 0 0 0 0 0 0 0 0 0 0 0 0 0 0 0 0 0 0 0 0 0 0 0 0 0 0 0 0 0 0 0 0 0 0 0 0 0 0 0 0 0 0 0 
0 0 0 0 0 0 0 0 0 0 0 0 0 0 0 0 0 0 0 0 0 0 0 0 0 0 0 0 0 0 0 0 0 0 0 0 0 0 0 0 0 0 0 0 0 0 0 0 0 0 
0 0 0 0 0 0 0 0 0 0 0 0 0 0 0 0 0 0 0 0 0 0 0 0 0 0 0 0 0 0 0 0 0 0 0 0 0 0 0 0 0 0 0 0 0 0 0 0 0 0 
