71 71 71 71 71 71 71 71 71 71 71 71 71 71 71 71 71 71 71 71 71 71 71 71 71 71 71 71 71 71 71 71 71 71 71 71 71 71 71 71 71 56 56 56 56 56 56 56 56 56
71 2 72 0 0 0 0 1 2 0 0 0 0 71 0 0 0 0 0 0 0 2 1 0 0 0 71 71 71 71 0 0 1 2 2 0 0 0 0 0 4 56 56 56 56 56 56 56 56 56
71 79 80 81 0 71 0 0 2 6 6 0 0 0 0 0 0 0 71 0 0 0 0 0 0 0 0 0 0 0 0 0 33 33 33 33 33 33 33 33 0 10 56 56 56 56 56 56 56 56
71 74 73 75 0 0 0 0 7 56 56 5 0 0 1 0 0 0 0 1 0 0 0 33 33 33 33 33 33 33 33 34 27 27 27 27 27 27 27 27 30 4 56 56 56 56 56 56 56 56
71 76 77 78 0 0 0 4 56 56 56 56 3 0 0 33 33 33 33 33 33 33 34 27 27 27 27 29 27 27 27 27 27 35 36 36 36 36 36 36 0 4 56 56 56 56 56 56 56 56
71 31 29 32 39 0 0 0 10 56 56 56 3 1 34 27 27 29 27 28 27 27 27 27 35 36 36 36 36 36 36 36 36 0 0 0 0 0 0 0 0 0 10 56 56 56 56 56 56 56
71 31 28 27 32 33 33 0 0 9 9 9 0 34 27 28 35 36 36 36 36 36 36 36 0 0 0 0 0 0 0 0 0 0 0 0 0 0 0 0 0 0 4 56 56 56 56 56 56 56
71 0 37 27 29 27 27 32 33 33 33 33 34 27 27 35 0 0 0 0 0 0 0 0 0 0 0 71 71 71 71 71 0 0 0 0 0 0 0 0 0 0 0 10 56 56 56 56 56 56
71 0 0 36 36 37 28 27 28 27 27 27 27 27 35 0 0 0 0 1 1 0 0 0 71 71 71 71 71 71 71 71 71 71 71 71 0 0 0 0 0 0 0 0 9 10 56 56 56 56
71 0 0 1 1 2 37 27 35 36 36 36 36 36 0 0 0 0 0 0 0 0 0 0 71 71 71 71 71 71 71 71 71 71 71 71 0 0 0 0 0 0 0 0 0 0 10 56 56 56
71 0 0 0 0 71 31 27 32 0 0 0 0 0 71 0 0 0 0 1 0 0 1 0 71 71 71 71 71 71 71 71 71 71 71 71 71 0 0 0 0 0 0 0 0 0 0 9 9 71
71 0 0 0 0 0 31 27 27 32 0 0 0 0 0 0 0 0 0 1 2 0 0 0 71 71 71 71 71 71 71 71 71 71 71 71 0 0 0 0 0 0 0 0 0 71 0 0 0 71
71 71 0 0 0 0 0 37 29 27 32 33 33 0 0 0 0 0 0 0 0 0 0 0 2 0 0 71 71 71 71 71 0 0 0 0 0 0 0 0 0 1 2 1 0 0 0 0 0 71
71 71 0 0 2 0 0 0 37 27 27 27 27 32 33 0 0 0 0 0 0 0 0 1 2 1 0 0 0 0 0 0 0 0 0 0 0 0 0 0 0 1 0 0 0 0 0 0 0 71
71 71 0 0 0 0 0 0 0 36 36 37 29 27 29 32 33 33 33 33 0 0 0 0 0 0 2 1 2 0 0 0 0 0 0 0 0 0 71 0 0 0 0 0 0 0 0 0 0 72
71 71 71 0 0 0 0 0 0 0 0 0 36 37 27 27 29 27 27 27 32 33 33 33 33 33 33 33 0 0 0 0 0 0 1 0 0 0 0 0 0 0 0 0 0 0 0 0 0 72
71 71 71 0 0 0 0 0 0 0 0 0 0 0 36 36 36 36 37 27 27 27 29 27 28 27 29 27 32 33 33 0 0 0 0 0 0 0 0 0 0 0 0 0 0 0 0 0 0 72
71 71 71 0 0 0 72 0 0 0 0 0 0 0 0 0 0 0 0 36 36 36 36 36 36 36 37 29 27 28 27 32 33 33 0 0 0 0 0 1 2 0 0 0 0 0 0 0 0 71
71 71 0 0 0 0 0 0 0 0 0 0 0 0 0 0 1 0 0 1 1 0 0 0 0 0 0 36 36 37 27 28 27 27 32 33 0 0 0 2 1 0 0 0 71 0 0 0 0 71
71 71 0 0 0 0 0 0 0 0 0 2 0 0 0 0 0 0 0 0 0 0 0 0 0 0 0 0 0 0 36 36 37 27 28 27 32 0 0 0 0 0 0 0 71 71 0 0 0 71
71 0 0 0 0 0 0 0 0 0 0 0 0 0 0 0 0 0 0 0 0 71 71 71 71 0 0 0 0 0 0 0 0 36 37 27 27 32 0 0 0 0 0 0 0 0 0 0 0 71
71 0 0 0 0 0 0 0 0 0 1 0 0 0 0 0 0 71 71 71 71 71 71 71 71 71 71 71 0 0 0 0 0 0 0 37 27 27 30 0 0 0 0 0 0 0 0 0 0 71
71 0 0 0 0 0 0 0 0 0 0 0 0 71 71 71 71 71 71 71 71 71 71 71 71 71 71 71 71 71 71 71 0 0 0 0 37 27 30 0 0 0 0 0 0 0 0 0 0 71
71 0 0 0 0 2 2 0 0 0 0 0 0 71 71 71 71 71 71 71 71 71 71 71 71 71 71 71 71 71 71 71 0 0 2 1 31 28 30 0 0 0 0 0 0 0 0 0 0 72
71 0 0 0 1 2 0 0 0 0 0 0 0 71 71 71 71 71 71 71 71 71 71 71 71 71 71 71 71 71 71 71 0 0 0 0 31 27 30 0 0 2 1 0 0 0 0 0 0 71
72 0 0 0 0 2 1 2 0 0 0 0 71 71 71 71 71 71 71 71 71 71 71 71 71 71 0 0 0 0 1 1 0 0 0 0 31 27 30 0 0 0 0 0 0 0 0 0 0 71
71 0 0 0 0 0 0 0 0 0 0 0 71 71 71 71 71 71 71 71 1 2 0 0 0 2 1 71 71 71 71 0 0 0 0 0 31 28 30 0 0 0 0 0 0 0 0 0 0 71
71 0 0 0 0 0 0 0 0 0 0 0 71 71 71 71 1 0 2 0 0 71 71 71 71 71 71 71 71 71 71 0 0 0 1 0 31 27 30 0 0 0 2 1 2 0 0 0 0 72
71 0 0 0 0 0 0 0 0 0 0 0 0 0 0 1 1 71 71 71 71 71 71 71 71 71 71 71 71 71 71 0 2 2 0 0 34 28 30 0 0 0 0 0 0 0 0 0 0 71
71 0 0 0 0 0 0 0 0 0 0 0 0 71 71 71 71 71 71 71 71 71 71 71 71 71 71 71 71 0 0 0 0 0 33 34 27 29 30 0 0 0 0 0 0 0 0 0 0 71
71 0 0 0 0 0 0 0 0 0 0 0 0 0 0 0 0 71 71 71 71 71 71 71 71 0 0 0 0 0 33 33 33 34 27 28 27 35 0 0 0 0 0 0 0 0 0 0 0 72
71 0 0 0 0 0 0 0 0 0 0 0 0 0 0 0 1 2 0 0 0 0 0 0 0 0 0 0 33 34 27 27 29 27 27 35 36 0 0 0 0 0 0 0 71 0 0 0 0 72
71 0 0 0 0 0 0 0 0 0 0 0 0 0 0 0 0 0 0 0 0 0 0 0 0 0 0 34 27 28 28 35 36 36 36 0 0 0 0 0 0 0 0 71 71 71 0 0 0 71
71 18 18 18 18 18 18 18 18 18 18 18 18 18 18 18 0 0 0 0 0 0 0 0 0 0 34 27 27 35 36 0 0 0 0 2 2 1 0 0 0 0 0 0 0 0 0 0 0 71
71 42 42 42 42 42 43 42 42 42 42 42 42 42 42 42 17 18 18 18 18 0 0 0 0 31 27 27 35 0 0 0 0 0 0 0 0 0 0 0 71 71 0 0 0 0 0 0 0 71
71 42 42 42 42 42 42 42 42 42 43 43 42 42 42 42 42 42 42 43 42 17 18 18 18 34 28 27 32 18 18 0 0 0 0 0 0 0 71 71 71 0 0 0 0 0 0 0 0 71
71 47 47 47 47 47 47 47 53 42 42 42 42 42 42 43 42 42 42 42 42 42 42 42 42 42 42 42 42 42 42 17 18 18 18 18 18 18 0 0 0 0 0 0 0 0 0 0 0 71
56 56 56 56 56 56 56 56 46 47 47 47 47 47 47 47 47 47 53 42 42 42 42 42 43 42 42 42 42 43 42 42 42 42 42 42 42 42 17 18 18 18 18 18 0 0 0 0 0 72
56 56 56 56 56 56 56 56 56 56 56 56 56 56 56 56 56 56 46 47 47 47 47 47 47 47 47 47 53 42 42 42 42 43 43 42 42 42 42 42 42 42 42 42 17 18 18 18 18 71
56 56 56 56 56 56 56 56 56 56 56 56 56 56 56 56 56 56 56 56 56 56 56 56 56 56 56 56 46 47 47 47 47 53 42 42 42 42 42 42 42 43 42 42 42 42 43 42 42 71
56 56 56 56 56 56 56 56 56 56 56 56 56 56 56 56 56 56 56 56 56 56 56 56 56 56 56 56 56 56 56 56 56 46 47 47 47 47 47 47 47 47 47 47 47 47 47 47 47 72
56 56 56 56 56 56 56 56 56 56 56 56 56 56 56 56 56 56 56 56 56 56 56 56 56 56 56 56 56 56 56 56 56 56 56 56 56 56 56 56 56 56 56 56 56 56 56 56 56 56
56 56 56 56 56 56 56 56 56 56 56 56 56 56 56 56 56 56 56 56 56 56 56 56 56 56 56 56 56 56 56 56 56 56 56 56 56 56 56 56 56 56 56 56 56 56 56 56 56 56
56 56 56 56 56 56 56 56 56 56 56 56 56 56 56 56 56 56 56 56 56 56 56 56 56 56 56 56 56 56 56 56 56 56 56 56 56 56 56 56 56 56 56 56 56 56 56 56 56 56
56 56 56 56 56 56 56 56 56 56 56 56 56 56 56 56 56 56 56 56 56 56 56 56 56 56 56 56 56 56 56 56 56 56 56 56 56 56 56 56 56 56 56 56 56 56 56 56 56 56
56 56 56 56 56 56 56 56 56 56 56 56 56 56 56 56 56 56 56 56 56 56 56 56 56 56 56 56 56 56 56 56 56 56 56 56 56 56 56 56 56 56 56 56 56 56 56 56 56 56
56 56 56 56 56 56 56 56 56 56 56 56 56 56 56 56 56 56 56 56 56 56 56 56 56 56 56 56 56 56 56 56 56 56 56 56 56 56 56 56 56 56 56 56 56 56 56 56 56 56
56 56 56 56 56 56 56 56 56 56 56 56 56 56 56 56 56 56 56 56 56 56 56 56 56 56 56 56 56 56 56 56 56 56 56 56 56 56 56 56 56 56 56 56 56 56 56 56 56 56
56 56 56 56 56 56 56 56 56 56 56 56 56 56 56 56 56 56 56 56 56 56 56 56 56 56 56 56 56 56 56 56 56 56 56 56 56 56 56 56 56 56 56 56 56 56 56 56 56 56
56 56 56 56 56 56 56 56 56 56 56 56 56 56 56 56 56 56 56 56 56 56 56 56 56 56 56 56 56 56 56 56 56 56 56 56 56 56 56 56 56 56 56 56 56 56 56 56 56 56